111111
1000P1
10C001
100C01
1E0001
111111