1111111111111111
1000P00001000111
111100000000E111
1111111111111111111
00000000000000000000
111111111111