1111111111111111
1000000C00000C01
100C111100000001
1C000000C1111001
1000P00000000111
11110000000000E1
1111111111111111