1111111111111111
10C0000100000001
10001111000E0001
1100000P11111001
1000100000000111
1111000000000011
1111111111111111